1)wavy orange bag: ['dark lavender bag', 'posh white bag']
2)striped green bag: ['light silver bag', 'plaid purple bag']
3)mirrored red bag: ['mirrored chartreuse bag', 'muted gold bag', 'bright beige bag', 'dim green bag']
4)pale gray bag: ['vibrant tomato bag']
5)striped purple bag: ['dotted gray bag']
6)faded fuchsia bag: ['posh fuchsia bag', 'drab salmon bag', 'posh orange bag']
7)dim gray bag: ['bright crimson bag', 'dotted salmon bag', 'plaid indigo bag']
8)dull red bag: ['dark cyan bag', 'bright indigo bag', 'clear brown bag', 'plaid violet bag']
9)light violet bag: ['pale beige bag', 'mirrored silver bag']
10)shiny fuchsia bag: ['pale gold bag', 'mirrored crimson bag', 'plaid gold bag', 'shiny yellow bag']
11)light salmon bag: ['striped red bag', 'wavy indigo bag', 'light tomato bag', 'dark cyan bag']
12)dull magenta bag: ['mirrored salmon bag', 'mirrored chartreuse bag', 'dull gray bag']
13)shiny turquoise bag: ['drab gold bag', 'posh teal bag', 'vibrant bronze bag', 'vibrant chartreuse bag']
14)wavy blue bag: ['light tomato bag', 'dim bronze bag', 'plaid green bag', 'dark maroon bag']
15)muted beige bag: ['bright black bag', 'dull magenta bag', 'shiny indigo bag']
16)light silver bag: ['pale red bag', 'vibrant plum bag', 'posh indigo bag']
17)light plum bag: ['light red bag', 'mirrored chartreuse bag', 'dark cyan bag']
18)drab plum bag: ['light indigo bag', 'dull silver bag', 'dim green bag', 'dim silver bag']
19)clear gray bag: ['dull coral bag', 'dim fuchsia bag']
20)dim coral bag: ['muted olive bag']
21)dotted olive bag: ['clear gray bag', 'dotted fuchsia bag', 'wavy tomato bag', 'bright maroon bag']
22)mirrored olive bag: ['drab salmon bag', 'light indigo bag']
23)vibrant salmon bag: ['light maroon bag', 'light olive bag', 'mirrored tomato bag']
24)dull purple bag: ['posh lavender bag', 'posh brown bag', 'plaid gray bag', 'clear red bag']
25)mirrored teal bag: ['posh chartreuse bag']
26)striped olive bag: ['clear purple bag', 'light cyan bag', 'mirrored chartreuse bag', 'plaid cyan bag']
27)dark cyan bag: ['faded violet bag', 'clear brown bag', 'shiny gold bag']
28)vibrant tomato bag: ['dim violet bag', 'clear gray bag']
29)faded bronze bag: ['dull silver bag', 'dim cyan bag', 'posh chartreuse bag', 'pale maroon bag']
30)clear fuchsia bag: ['light lime bag', 'shiny lavender bag']
31)muted cyan bag: ['vibrant purple bag', 'posh cyan bag', 'muted red bag', 'shiny indigo bag']
32)light coral bag: ['plaid gray bag', 'plaid magenta bag', 'faded tan bag', 'clear blue bag']
33)plaid gray bag: ['dark crimson bag', 'vibrant aqua bag', 'posh lime bag', 'faded bronze bag']
34)bright crimson bag: ['faded bronze bag', 'dark cyan bag', 'shiny purple bag', 'drab gold bag']
35)drab red bag: ['dim silver bag', 'dim purple bag']
36)plaid silver bag: ['wavy black bag', 'muted plum bag', 'posh blue bag']
37)striped indigo bag: ['dotted indigo bag', 'dim lavender bag', 'wavy yellow bag', 'pale gold bag']
38)bright green bag: ['light olive bag']
39)dotted gold bag: ['drab magenta bag', 'clear fuchsia bag', 'shiny violet bag', 'dark indigo bag']
40)muted olive bag: ['mirrored olive bag']
41)dark brown bag: ['plaid coral bag', 'dark tan bag', 'dotted bronze bag']
42)wavy gray bag: ['pale turquoise bag']
43)pale olive bag: ['plaid gray bag', 'striped coral bag']
44)vibrant violet bag: ['bright red bag', 'posh coral bag', 'wavy aqua bag']
45)vibrant red bag: ['mirrored beige bag', 'wavy indigo bag', 'light coral bag', 'mirrored salmon bag']
46)striped plum bag: ['striped purple bag', 'pale red bag']
47)vibrant chartreuse bag: ['bright red bag', 'bright gray bag', 'faded bronze bag', 'vibrant crimson bag']
48)dark teal bag: ['shiny chartreuse bag', 'mirrored fuchsia bag', 'bright green bag']
49)bright silver bag: ['shiny fuchsia bag', 'dotted blue bag', 'posh indigo bag']
50)dull orange bag: ['striped purple bag', 'muted green bag', 'vibrant indigo bag']
51)dim purple bag: ['posh chartreuse bag', 'dark chartreuse bag', 'faded indigo bag', 'bright purple bag']
52)pale cyan bag: ['mirrored gray bag', 'muted beige bag', 'plaid lime bag']
53)faded green bag: ['pale olive bag', 'shiny crimson bag', 'faded silver bag']
54)muted plum bag: ['dotted white bag', 'plaid coral bag', 'dim purple bag', 'dim fuchsia bag']
55)light olive bag: ['pale beige bag', 'wavy maroon bag', 'pale crimson bag', 'striped gray bag']
56)dim white bag: ['vibrant aqua bag', 'bright green bag', 'vibrant maroon bag', 'dim tomato bag']
57)light cyan bag: ['drab chartreuse bag', 'clear gray bag', 'clear indigo bag', 'vibrant black bag']
58)faded silver bag: ['drab cyan bag', 'light cyan bag', 'clear tan bag']
59)plaid turquoise bag: ['faded silver bag', 'striped bronze bag', 'drab purple bag']
60)faded blue bag: ['striped olive bag', 'dull chartreuse bag']
61)dark salmon bag: ['dark maroon bag', 'dark teal bag']
62)dim black bag: ['dotted blue bag', 'drab indigo bag', 'clear indigo bag']
63)clear magenta bag: ['striped bronze bag', 'posh orange bag', 'dotted olive bag', 'dull cyan bag']
64)vibrant plum bag: ['mirrored plum bag', 'vibrant olive bag', 'clear gray bag', 'mirrored tomato bag']
65)pale teal bag: ['mirrored white bag', 'wavy plum bag', 'pale indigo bag', 'bright turquoise bag']
66)plaid green bag: ['mirrored chartreuse bag', 'wavy yellow bag']
67)posh chartreuse bag: ['clear gray bag', 'striped lavender bag', 'striped coral bag']
68)muted salmon bag: ['dotted brown bag', 'dim lavender bag', 'muted violet bag']
69)light indigo bag: ['dark cyan bag', 'drab chartreuse bag', 'clear tomato bag']
70)dull coral bag: ['shiny gold bag', 'dark red bag', 'faded chartreuse bag', 'vibrant orange bag']
71)dotted maroon bag: ['dotted magenta bag', 'drab gray bag', 'clear gray bag']
72)faded salmon bag: ['muted salmon bag']
73)striped gold bag: ['vibrant olive bag', 'vibrant tomato bag', 'wavy red bag', 'bright orange bag']
74)faded gray bag: ['dim white bag', 'bright bronze bag', 'drab violet bag']
75)mirrored chartreuse bag: ['dull coral bag', 'dark gray bag', 'bright red bag', 'posh blue bag']
76)dim lavender bag: ['dim yellow bag', 'dark coral bag', 'wavy plum bag']
77)shiny olive bag: ['pale gray bag', 'striped coral bag', 'dotted green bag']
78)striped orange bag: ['striped plum bag']
79)dim yellow bag: ['dark olive bag', 'dim lime bag', 'bright crimson bag', 'dim fuchsia bag']
80)muted teal bag: ['vibrant purple bag', 'mirrored orange bag', 'drab green bag']
81)pale orange bag: ['posh maroon bag', 'clear olive bag', 'muted beige bag', 'dim violet bag']
82)drab turquoise bag: ['pale beige bag', 'dull beige bag', 'dark black bag']
83)posh fuchsia bag: ['dull beige bag', 'light turquoise bag', 'pale violet bag', 'pale beige bag']
84)pale turquoise bag: ['mirrored lavender bag', 'posh maroon bag', 'pale gold bag', 'clear gray bag']
85)pale lavender bag: ['mirrored maroon bag', 'pale gray bag']
86)drab indigo bag: ['vibrant plum bag', 'striped crimson bag', 'dim violet bag']
87)dotted gray bag: ['dark cyan bag', 'mirrored fuchsia bag']
88)dim orange bag: ['dotted lime bag', 'posh violet bag', 'dotted indigo bag']
89)light lime bag: ['vibrant plum bag']
90)faded turquoise bag: ['vibrant indigo bag', 'dotted indigo bag', 'mirrored silver bag']
91)wavy lime bag: ['dark cyan bag', 'vibrant green bag']
92)dim crimson bag: ['posh chartreuse bag']
93)clear gold bag: ['striped red bag', 'shiny gold bag', 'light green bag', 'dark blue bag']
94)faded orange bag: ['wavy green bag', 'bright purple bag', 'dark cyan bag']
95)muted blue bag: ['dotted bronze bag', 'light olive bag']
96)muted chartreuse bag: ['posh purple bag', 'dull magenta bag', 'dim silver bag', 'bright indigo bag']
97)wavy silver bag: ['muted salmon bag', 'bright salmon bag', 'posh magenta bag', 'dim brown bag']
98)pale beige bag: ['clear gold bag', 'dim tomato bag', 'posh crimson bag', 'drab gray bag']
99)posh silver bag: ['wavy bronze bag', 'plaid green bag', 'drab fuchsia bag', 'wavy red bag']
100)dull gold bag: ['dark salmon bag']
101)dotted indigo bag: ['drab turquoise bag', 'posh purple bag']
102)wavy gold bag: ['muted chartreuse bag']
103)wavy magenta bag: ['plaid chartreuse bag', 'muted bronze bag']
104)vibrant purple bag: ['mirrored turquoise bag', 'plaid gray bag']
105)dark lavender bag: ['dull red bag']
106)pale indigo bag: ['plaid green bag', 'dull aqua bag']
107)bright cyan bag: ['light cyan bag', 'vibrant crimson bag', 'faded cyan bag']
108)clear beige bag: ['plaid yellow bag', 'drab white bag', 'drab lime bag', 'dim orange bag']
109)mirrored crimson bag: ['mirrored chartreuse bag', 'muted red bag', 'vibrant purple bag']
110)striped salmon bag: ['plaid fuchsia bag', 'muted teal bag']
111)posh coral bag: ['pale beige bag', 'plaid salmon bag']
112)dark tan bag: ['clear green bag', 'light cyan bag', 'light chartreuse bag', 'dark lime bag']
113)clear coral bag: ['wavy beige bag', 'muted cyan bag', 'dark turquoise bag', 'posh green bag']
114)muted bronze bag: ['striped teal bag', 'faded brown bag', 'light silver bag', 'muted beige bag']
115)plaid brown bag: ['dull magenta bag']